############
#A         #
# ### ######
#   #   #  #
# # ### ## #
# # #   #  #
# # ##### ##
# #       B#
## #########
#          #
############