##############################
#A# ############        #    #
# #           ## ###### # ## #
# # ######### ## #   ## # #  #
# #       #   ## # # ## # ## #
# # ####### # ## # # ## # #  #
# # #       # ## # # ## # ## #
# # # ##### # ## # # ## #    #
#   #     # # ## # # ## ######
# # ##### # # ## # # ##    ###
# #   #   # # ## # # #####  B#
# ### # ### # ## # #     #####
#   #     # # ## # # #########
### ####### # ## # # #     # #
# #         # ## # # # ### # #
# # ######### ## # # # #   # #
# #              # # # # # # #
# ########### ## # # # # # # #
#             ##   # # # # # #
########### ######## # # # # #
#       #   #        # # # # #
# ##### # ########## # # # # #
#     # # #          # # # # #
##### # # ############ # # # #
#   # # #              # # # #
# # # # ############## # # # #
##############################