#####################
#A  #               #
# # # ########### # #
# # #           # # #
# # ########### # # #
# #         #   #   #
# # ######### ##### #
# #         #   # # #
# ######### ### # # #
#       #   #     # #
####### # ####### # #
#     # #         # #
# ### # ######### # #
#   # #         # # #
# ### ######### # # #
#   #           # # #
# ############### # #
#               #   #
###################B#
