################################
#A      #       #       #      #
# ### ### ### ######### ####### #
# #     #   # #       # #     # #
# # ##### ### # ##### # # ### # #
# #     #     # #     #   # # # #
# # ### ##### # ##### ### # # # #
# #   #     # #   #     # # # # #
# ### ### ### ### # ### # # # # #
# #     #   #     #   # # # # # #
# # ##### ### ##### ### # # # # #
# #     #     #   #   # # # # # #
# # ######### ### # ### # # # # #
# #       # #     #   # # # # # #
# ####### # # ##### # # # # # # #
# #     # # #     # # # # # # # #
# # ### # # ##### # # # # # # # #
# # #   #   #   # # # # # # # # #
# # # ##### # # # # # # # # # # #
# # #       # #   # # # # # # # #
# # ######### ##### # # # # # # #
# #                 # #B# # # # #
# ################### # # # #
